############################################
#..S.....................#.................#
#.....#.........(.........................)#
#.....###...........#.........#............#
###.................#......................#
#.........###.............#.....#........###
#.................#.............#...#.....X#
#...##...#........X#...##..................#
#..............#...........................#
##...................................#.....#
#....................####............#.....#
#..#........##.............#...#.....#.....#
#.......#...........#...........#....#.....#
#.......#.......#...#......................#
#...#.......#..............#...........##..#
#.......######.............#...............#
#...#...G#...#....##......................##
#...##..##...#.......#..............#......#
#............###...........#........##.....#
#........#.................................#
#...X#..........###......X#.......#........#
############################################