############################################
#........................#.................#
#.....#.....#########.............##########
#.....#.............#.........#...........G#
###########.........#.........##.##........#
#.........#.....................#..........#
#.........#.......#.............#...#......#
#...##....#..........................#######
#.........#....#.....................#....X#
#.........######.......S.............#.....#
#....................................#.....#
#...#####...##.............#...#.....##....#
#.......#..............(...#....#....#.....#
#.......#.......#..........#...............#
#...#.......#..............#...............#
#.......######.............######..........#
#............#....##......................##
#...##.......#......................#......#
#............#.............#........##.....#
#............######....)...#...............#
#X.....#...................#...............#
############################################