############################################
#..........................................#
#...........#########.............##########
#.........................................G#
###########................................#
#.........#................................#
#.........#................................#
#.........#..........................#######
#.........#..........................#.....#
#.........######.......R.............#.....#
#....................................#.....#
#..........................#.........#.....#
#..........................#.........#.....#
#..........................#...............#
#..........................#...............#
#.......######.............######..........#
#............#.............................#
#............#.............................#
#............#.............#...............#
#............######........#...............#
#..........................#...............#
############################################