############################################
#..........................................#
#...........#########.............##########
#.........................................G#
###########................................#
#.........#................................#
#.........#................................#
#.........#..........................#######
#.........#..........................#....X#
#.........######.......R.............#.....#
#....................................#.....#
#..........................#.........#.....#
#......................(...#.........#.....#
#..........................#...............#
#..........................#...............#
#.......######.............######..........#
#............#.............................#
#............#.............................#
#............#.............#...............#
#............######....)...#...............#
#X.........................#...............#
############################################